BBBBBBBBBBBBMBBBBBBBBBBB
BMBPPPPBPPPBBPPPPBBPPBMB
BBBMBBBBBBBBBBBBBBBMBPBB
BPPBPBBBBPBMBBBBBBPBPPBB
BBPBBBBBBPPPPPBBBBBPPBBB
BBBPPBPBBBMBBBBPBBBBBBBB
BBBBBBBBBBBBBBBPBPPBBBBB
BBBBBPPBPBBMBBBPBBBBBBBB
BBBMBBPPBBBBBBBBBPPBBMBB
BBBBBBBPBBBBBBBBPPBBBBBB
BBBPPBBMBPBBBPBBBBBBBBBB
BBBBBBBBBBBBBBPPBBBBBBBB
BMBBBPPBBBBBPPBBBBBBBMBB
BBPBBMBBBBJBBPBBBBBBBPBB
BMBBBBBBBBBBBBBMBBBBBMBB
BBBBBBBBBBBBBBBBBBBBBBBB