BBBBBBBBBBBBBBBBBBBBBBBB
BBBBBMBBBBBBBBBBBPPPPBBB
BBBBBBBBBBBBBBMBBPBBBBBB
BBBBBBBBBBBBBBBBPBBBBBBB
BBBBBBBMBBBBBBPPBBBBBBBB
BBBBBBBBBBBPPPPBBBBBBBBB
BBBBBBBBBBBBBBBBBBMBBBBB
BBBBBBBBBBBBBBBMBBBBBBBB
BBBBBBBBBBBBBBBBBBBBBBBB
BBBBBBBJBBBPBBBBBBBBBBBB
BBBMBBBBBBBPBBBBBBBBBBBB
BBBBBBBBBBBPBBBBBBBBBBBB
PPPPPPPPPPPPBBBBBBBBBBBB
BBBBBBBBBBBBBBBBBBBBBBBB
BBBBBBBBBBBBBBMBBBBBBBBB
BBBBBBBBBBBBBBBBBBBBBBBB