BBBBBBBBBBBBMBBBBBBBBBBB
BMBPPPPBPPPBBPPPPBBPPBMB
BBBMBBBBBBBBBBBBBBBMBPBB
BPPBPBBBBPBMBBBBBBPBPPBB
BBPPBPBBBPPPPPBBBBBPPBBB
BBBPPBPBBBMBBBBPBPPBBBBB
BBBBBBBBBBBBBBBPBPPBBBBB
BBBBBPPBPBBMBBBPBBBBBBBB
BBBMBBPPBBBBBBBBBPPBBMBB
BBBBBBBPBBBBBBBBPPBBBBBB
BBBPPBBMBPBBBPBPPBBBBBBB
BBBBBBBBBPPBBBPPBBBBBBBB
BMBBBBBBBPPBPPBBBBBBBMBB
BBPBBMBBBBJBBPBBBBBBBPBB
BMBBBBBBBBBBBBBMBBBBBMBB
BBBBBBBBBBBBBBBBBBBBBBBB