BBBBBBMBBBBBBBBBBBMBBBBB
BMBPPPPBBBBBBBMBBPPPPBMB
BPBMBPBPBMBBBBBBBBBBBMBP
BPPBBBBBPBBBBBBBPBPBPBPP
BBPPBBBBBBBBBBBPBBBBBBPB
BBBPPBPBBBPPBBBBBBBBPPBB
BBBBMBPBBBBBMBBBBPBMBBBB
BBBBBBBBBBBBBBBBBBPBBBBB
BBBBMBPBPBPBBPBPBPBMBBBB
BBBPPBPBPBPBBBBBBBBPBBBB
MBPPBBBBBMBBBBBPMBBBBBBB
BBPBBBBBBBBBBBBBPBPBPBBP
BBBMBPBPBBBBBBBBBPBPBMBP
BMBPPPBBBBBJBBPBPPPPBMBB
BBBBBMBBBBBBBBBBBBBBBBBB
BBBBPPPPPPBBBMBBBMBBBBBB