BBBBBBMBBBBBBBBBBBMBBBBB
BMBPPPPBBBBBBBMBBPPPPBMB
BPBMBPBPBMBBBBBBBBBBBMBP
BBBBBBBBPBBBBBBBPBPBPBPP
BBPPBBBBBBBBBBBPBBBBBBPB
BBBPPBPBBBPPBBBBBBBBPPBB
BBBBMBPBBBBBMBBBBPBMBBBB
BBBBBBBBBBBBBBBBBBPBBBBB
BBBBMBPBPBPBBPBPBPBMBBBB
BBBPPBPBPBPBBBBBBBBPBBBB
MBPPBBBBBMBBBBBPMBBBBBBB
BBPBBBBBBBBBBBBBBBBBPBBP
BBBMBPBPBBBBBBBBBPBPBMBP
BMBPPPBBBBBJBBPBPPPPBMBB
BBBBBMBBBBBBBBBBBBBBBBBB
BBBBPPPPPPBBBMBBBMBBBBBB